########
##    !#
# X @# #
#  # # #
#  ### #
#      #
#   #  #
########